**********
*P    *  *
*        *
**       *
*        *
*   *  E *
*   * ****
*  *     *
*       G*
**********