**********
*P    *  *
*        *
**       *
*        *
*   *    *
*   * ****
*  *     *
*       G*
**********